NO ./path_to_the_north_texture.xmp
SO ./path_to_the_south_texture.xmp
WE ./path_to_the_west_texture.xmp
EA ./path_to_the_east_texture.xmp

F 0,75,73
C 112,83,53

1111111111111111111111111
1000000000110000000000001
1011000001110000000000001
100100000000000000000000111111111
111111111011000001110000000000001
100000000011000001110111111111111
11110111111111011100000010001
11110111111111011101010010001
11000000110101011100000010001
10000000N00000001100000010001
10000000000000001101010000001
1100000111010101110101101000111
11110111111010110111101000111
11111111111111111111111111111
