NO ./path_to_the_north_texture.xmp
SO ./path_to_the_south_texture.xmp
WE ./path_to_the_west_texture.xmp
EA ./path_to_the_east_texture.xmp

F 0,75,73
C 112,83,53

1111111111111111111111111
1000000000110000000000001
10110000011100000N0000001
1001000000000000000000001
1111111111111111111111111
