NO ./sprites/wall1.xpm
SO ./sprites/wall2.xpm
WE ./sprites/wall7.xpm
EA ./sprites/wall8.xpm

F 0,75,73
C 142,200,216

        11111111111 1111111111111
        10000000001 1000000000001
        101100000111100000E000001
        1001000000000000000000001
111111111011000001110000000000001
100000000011000001110111111111111
11110111111111011100000010001
11000111111111011101010010001
11011100110101011100000010111
1001 100000000001100000010001
1001110000000000110101000000111
1100000111010101110101101000001
11110111 1110101 10111101000111
11110111 1111111 1111111111111
100001
111111