NO ./sprites/wall1.xpm
SO ./sprites/wall2.xpm
WE ./sprites/wall2.xpm
EA ./sprites/wall1.xpm

F 0,75,73
C 112,83,53

        1111111111111111111111111
        1000000000110000000000001
        101100000111000000E000001
        1001000000000000000000001
111111111011000001110000000000001
100000000011000001110111111111111
11110111111111011100000010001
11110111111111011101010010001
11000000110101011100000010001
10000000000000001100000010001
10000000000000001101010000001
1100000111010101110101101000111
11110111 1110101 101111010001
11111111 1111111 111111111111
