NO ./sprites/wall1.xmp
SO ./sprites/wall1.xmp
WE ./sprites/wall1.xmp
EA ./sprites/wall1.xmp

F 0,75,73
C 112,83,53

1111111111111111111111111
1000000000000000000000001
10000000000000000N0000001
1000000000000000000000001
1111111111111111111111111
