NO ./sprites/wall1.xmp
SO ./sprites/wall1.xmp
WE ./sprites/wall1.xmp
EA ./sprites/wall1.xmp

F 0,75,73
C 112,83,53

11111111111111111111111111111
11111111101100000111000000001
10000000001100000111011111111
11110111111111011100000010001
11110111111111011101010010001
11000000110101011100000010001
10000000000000001100000N10001
10000000000000001101010000001
11000001110101011101011010001
11111111111111111111111111111
11111111111111111111111111111
